AAAAAAAAAAAAAAAAAAAAAAAAAAAAAAAAAAAAABBBBBB
AAAABBBBBBBBBBBBBAAAAAAAAAAAAAAAAAAABBBBBBB
AAAABBBBBBBBBBBBBAAAAAAAAAAAAAABBBBBBBBBBBB
AAAAAAAAAAAAAAAAAAAAABBBBBBBBBBBBAAABBBBBBB
AAAAAAAAAAAAAAAAAAAAABBBBBBBBBBBBAAABBBBBBB
AAAAAAAAAAAAAAAAAAAAAAAAAAAABBBBBBBBBBBBBBB
AAAAAAAAAAAAAABAAAABAAAAAAABBBBBBAAAAAAAAAA
AAAAAAAAABAAAAAAABAAAABAAAAAAAAAAAAAAAAAAAA
AAABAAAAAAAABAAAAAAAAAAAAAAAAAAAAAAAAAAAAAA
AAAAAAAAAAAAAAAAAAAAAAAAAAAAAAAAAAAAAAAAAAA
AAAAAAAAAAAAAAAAAAAAAAAAAAAAAAAAAAAAAAAAAAA
AAAAAAAAAAAAAAAAAAAAAAAAAAAAAAAAAAAAAAAAAAA
AAAAAAAAAAAAAAAAAAAAAAAAAAAAAAAAAAAAAAAAAAA
AAAAAAAAAAAAAAAAAABBBBBAAAAAAAAAAAAAAAAAAAA
AAAAAAAAAAAAAAAAAABBBBBAAAAAAAAAAAAAAAAAAAA
AAAAAAAAAAAAAAAAAABBBBBAAAAAAAAAAAAAAAAAAAA
AAAAAAAAAAAAAAAAAAAAAAAAAAAAAAAAAAAAAAAAAAA
