AAAAAAAAAAAAAAAAAAAAAAAADAA
AAAABBBBBBBBBBBBBAAAAAAAAAA
AAAABBBBBBBBBBBBBAAAADAADAA
AAAAAAAAAAAAAAAAAAAAABBBBBB
AAAELKAAACAAAAAAAAAAABBBBBB
AAAFMJAAADDDDDDDDDDAAAAAAAA
AAAGHIDDDDDDDABAAAABAAAAAAA
AAAAAAAAABAAAAAAABAAAABAAAA
