AAAAAAAAAAAAAAAAAAAAAAAAAAAAAAAAAAAAAAAAAAA
AAACAAAAAAAAAAAACAAAAAAAAAAAAACCAAAAAAAAAAA
AAAAAAAABBBBBBBBBBBAAAAAAAAAAAAAAACAAAAAAAA
AACAAAAABBBBBBBBBBBAAAAAAAACCAAAAAAAAAAAAAA
AAAAAAAAAAAAADAAAAAAAAADDDDDAAAAAAAAAABBBBB
AAAACAAAAAAAADDDDDDDDDCDELKDAAAAAAAAAABBBBB
AAAAAAAAAAAAAAAAAAAAAAADFMJDAAAAAAAAAABBBBB
AAABACAAADDDDDAAAAAAAAADGHIDAAAADAAAAAAACAA
BBBBAAAAAAADELKDACAAAAADDDDDAAAADAAAAAAAAAA
BBBBAAAAAAADFMJDDDDDDDDDDDDDAAAACAAAAAAAAAA
AAABACAAAAADGHIDAAAAAAAAAAADAAAAAAAAAAAAAAA
AAAAAAAAAAADDDDDAAAAAAAAAAADACAAAAAAAAAAAAA
AAAAAAAAAAADDDDDDDDDDDDDDDDDAAAAAAACCCAAAAA
AAAAAAAAAAAAAAAAAAAAAAAAAAADAAAAABBBBBAAAAA
AAAACAAAAAAAAAAACACAAAAAAADAAAAAABBBBBAAAAA
AAAAAAAAAAAAAAAAAAAAAAAAAAADAAAAAAAAAAAAAAA