AAAAAAAAAAAAAAAAAAAAAAAADAAAAAAAAAAAABBBBBB
AAAABBBBBBBBBBBBBAAAAAAAAAAAAAAAAAAABBBBBBB
AAAABBBBBBBBBBBBBAAAADAADAAAAAABBBBBBBBBBBB
AAAAAAAAAAAAAAAAAAAAABBBBBBBBBBBBAAABBBBBBB
AAAAAAAAACAAAAAAAAAAABBBBBBBBBBBBAAABBBBBBB
AAAAAAAAADDDDDDDDDDAAAAAAAAABBBBBBBBBBBBBBB
AAACADDDDDDDDABAAAABAAAAAAABBBBBBAAAAAAAAAA
AAAAAAAAABAAAAAAABAAAABAAAAAAAAAAAAAAAAAAAA
AAABAAAAAAAABAAAAAAAAACAAAAAAAAAAAAAAAAAAAA
AAAACAADDDDDDDDAAAAAAAAAAAAAAAAAAAAAAAAAAAA
AAAAAADDDDDDDDDDDAAAAAAAAAAAAAAAAABAAAAAAAA
AAAAAAAAAAAAAAAAAAAAAAAAAAAAAAAAAAAAAAAAAAA
AAAAAAAAAAAAAAAAAAAAAAAAAAAAAAAAAAAAAAAAAAA
AAAAAAAAAAAAAAAAAABBBBBAAAAAAAAAAAAAAAAAAAA
AAAAAAAAAAAAAAAAAABBBBBAAAAAAAAAAAAAAAAAAAA
AAAAAAAAAAAAAAAAAABBBBBAAAAAAAAAAAAAAAAAAAA
AAAAAAAAAAAAAAAAAAAAAAAAAAAAAAAAAAAAAAAAAAA