AAAAAAAAAAAAAAAAAAAAAAAADAAAAAAAAAAAABBBBBB
AAAABBBBBBBBBBBBBAAAAAAAAAAAAAAAAAAABBBBBBB
AAAABBBBBBBBBBBBBAAAADAADAAAAAABBBBBBBBBBBB
AAAAAAAAAAAAAAAAAAAAABBBBBBBBBBBBAAABBBBBBB
AAAELKAAACAAAAAAAAAAABBBBBBBBBBBBAAABBBBBBB
AAAFMJAAADDDDDDDDDDAAAAAAAAABBBBBBBBBBBBBBB
AAAGHIDDDDDDDABAAAABAAAAAAABBBBBBAAAAAAAAAA
AAAAAAAAABAAAAAAABAAAABAAAAAAAAAAAAAAAAAAAA
AAABAAAAAAAABAAAAAAAAACAAAAAAAAAAAAAAAAAAAA
AAAACAADDDDDDDDAAAAAAAAAELKAAAAAAAAAAAAAAAA
AAAAAADDDDDDDDDDDDDDDDDDFMJDDDDDAABAAAAAAAA
AAAAAAAAAAAAAAAAAAAAAAAAGHIAAAAAAAAAAAAAAAA
AAAAAAAAAAAAAAAAAAAAAAAAAAAAAAAAAAAAAAAAAAA
AAAAAAAAAAAAAAAAAABBBBBAAAAAAAAAAAAAAAAAAAA
AAAAAAAAAAAAAAAAAABBBBBAAAAAAAAAAAAAAAAAAAA
AAAAAAAAAAAAAAAAAABBBBBAAAAAAAAAAAAAAAAAAAA
AAAAAAAAAAAAAAAAAAAAAAAAAAAAAAAAAAAAAAAAAAA