AAAAAAAAAAAAAAAAAAAAAAAAAAAAAAAAAAAAAAAAAAA
AAACAAAAAAAAAAAACAAAAAAAAAAAAACAAAAAAAAAAAA
AAAAAAAAAAAAAAAAAAAAAAAAAAAAAAAAAAAAAAAAAAA
AAAAAAAAACAAAAAAAAAAAAAAAACCAAAAAAAAAAAAAAA
AAAAAAAAAAAAAAAAAAAAAAABBBBBBBBBBAAAAAAAAAA
AAAAAAAAAAAAAAAAAAAAAACBBBBBBBBBBAAAAAAAAAA
AAAAAAAAAAAAAAAAAAAAAAABBBBBBBBBBAAAAAAAAAA
AAAAAAACAAADDDDDAAAAAAAAAAADAAAAAAACAAAAAAA
AAAAAAAAAAADELKDACAAAAAAAAADAAAAAAAAAAAAAAA
AAAAAAAAAAADFMJDDDDDDDDDDDDDAAAACAAAAAAAAAA
AAAAACAAAAADGHIDAAAAAAAAAAADAAAAAAAAAAAAAAA
AAAAAAAAAAADDDDDAAAAAAAAAAADACAAAAAAAAAAAAA
AAAAAAAAAAADDDDDDDDDDDDDDDDDAAAAAAAAAAAAAAA
AAAAAAAAAAAAAAAAAAAAAAAAAAADAAAAAAAAAAAAAAA
AAAAAAAAAAAAAAAAACACAAAAAAADAAAAAAAAAAAAAAA
AAAAAAAAAAAAAAAAAAAAAAAAAAADAAAAAAAAAAAAAAA